1111111111111111111111111
1000000000000000000000001
1000000000000000000000001
1000000000000000000000001
1000000001100011000000001
1000000001100011000000001
1000000000000000000000001
1000000000000000000000001
1000000000000000000000001
1000110000000000000110001
1000110000000000000110001
1000000000000000000000001
1000000000000000000000001
1000000000000000000000001
1000110000000000000110001
1000110000000000000110001
1000000000000000000000001
1000000000000000000000001
1000000000000000000000001
1000000001100011000000001
1000000001100011000000001
1000000000000000000000001
1000000000000000000000001
1000000000000000000000001
1111111111111111111111111