1111111111111111111111111
1111111111111111111111111
1111111111111111111111111
1110000000000000000000111
1110000000000000000000111
1110011000100010001100111
1110011111100011111100111
1110001000000000001000111
1110001000000000001000111
1110001000000000001000111
1110011000000000001100111
1110000000000000000000111
1110000000000000000000111
1110000000000000000000111
1110011000000000001100111
1110001000000000001000111
1110001000000000001000111
1110001000000000001000111
1110011111100011111100111
1110011000100010001100111
1110000000000000000000111
1110000000000000000000111
1111111111111111111111111
1111111111111111111111111
1111111111111111111111111