1111111111111111111111111
1110000000000000000000111
1110000000000000000000111
1001000000000000000001001
1000100000000000000010001
1000010000000000000100001
1000001000000000001000001
1000000000000000000000001
1000000000000000000000001
1000000001100011000000001
1000000001100011000000001
1000000000000000000000001
1000000000000000000000001
1000000000000000000000001
1000000001100011000000001
1000000001100011000000001
1000000000000000000000001
1000000100000000000000001
1000001000000000001000001
1000010000000000000100001
1000100000000000000010001
1001000000000000000001001
1110000000000000000000111
1100000000000000000000111
1111111111111111111111111