1111111111111111111111111
1111111111111111111111111
1111111111111111111111111
1110000000000000000000111
1110000000000000000000111
1110000000000000000000111
1110000000000000000000111
1110000000000000000000111
1110000000000000000000111
1110000001100011000000111
1110000001000001000000111
1110000000000000000000111
1110000000000000000000111
1110000000000000000000111
1110000001000001000000111
1110000001100011000000111
1110000000000000000000111
1110000000000000000000111
1110000000000000000000111
1110000000000000000000111
1110000000000000000000111
1110000000000000000000111
1111111111111111111111111
1111111111111111111111111
1111111111111111111111111