1111111111111111111111111
1111000000000000000001111
1110000000000000000000111
1100000000000000000000011
1000000001100011000000001
1000000011100011100000001
1000000110000000110000001
1000001100000000011000001
1000011000000000001100001
1000110000000000000110001
1000110000000000000110001
1000000000000000000000001
1000000000000000000000001
1000000000000000000000001
1000110000000000000110001
1000110000000000000110001
1000011000000000001100001
1000001100000000011000001
1000000110000000110000001
1000000011100011100000001
1000000001100011000000001
1100000000000000000000011
1110000000000000000000111
1111000000000000000001111
1111111111111111111111111