1111111111111111111111111
1111111111111111111111111
1100000000000000000000011
1100000000000000000000011
1100000000000000000000011
1100000000000000000000011
1100001100010100011000011
1100001100000000011000011
1100000000010100000000011
1100000000010100000000011
1100000000010100000000011
1100001011110111101000011
1100000000000000000000011
1100001011110111101000011
1100000000010100000000011
1100000000010100000000011
1100000000010100000000011
1100001100000000011000011
1100001100010100011000011
1100000000000000000000011
1100000000000000000000011
1100000000000000000000011
1100000000000000000000011
1111111111111111111111111
1111111111111111111111111