1111111111111111111111111
1111111111111111111111111
1111111111111111111111111
1110000000000000000000111
1110000000000000000000111
1110000000000011111100111
1110000001111111111100111
1110000001100000000000111
1110000001100000000000111
1110000001100011111111111
1110000001100011111111111
1110000001100011111111111
1110000001100011111111111
1110000001100011111111111
1110000001100011111111111
1110000001100011111111111
1110000000000000000000001
1110000000000000000000001
1110000000000000000000001
1110000000000000000000001
1110000000000000000000001
1111111111100000000000001
1111111111100000000000001
1111111111100000000000001
1111111111111111111111111