1111111111111111111111111
1111111111111111111111111
1111111110000000111111111
1111111110000000111111111
1111111110000000111111111
1110000000000000000000111
1110000000000000000000111
1110000000000000000000111
1111111110000000111111111
1111111110000000111111111
1111111110000000111111111
1110000000000000000000111
1110000000000000000000111
1110000000000000000000111
1111111110000000111111111
1111111110000000111111111
1111111110000000111111111
1110000000000000000000111
1110000000000000000000111
1110000000000000000000111
1111111110000000111111111
1111111110000000111111111
1111111110000000111111111
1111111111111111111111111
1111111111111111111111111