1111111111111111111111111
1000000000000000000000001
1000000000000000000000001
1000000000000000000000001
1000111111100011000000001
1000111111100011000000001
1000110000000011000000001
1000110000000011000000001
1000110000000011000000001
1000111111111111111110001
1000111111111111111110001
1000000000000000000000001
1000000000000000000000001
1000000000000000000000001
1000111111111111111110001
1000111111111111111110001
1000000001100000000110001
1000000001100000000110001
1000000001100000000110001
1000000001100011111110001
1000000001100011111110001
1000000000000000000000001
1000000000000000000000001
1000000000000000000000001
1111111111111111111111111